SYMBOL	CIC
BATF	T cell
BTLA	T cell
CCL11	T cell
CCL17	T cell
CCL22	T cell
CCL3	T cell
CCL5	T cell
CCL7	T cell
CCR1	T cell
CCR3	T cell
CCR4	T cell
CCR8	T cell
CD1A	T cell
CD1B	T cell
CD1C	T cell
CD1D	T cell
CD1E	T cell
CD247	T cell
CD28	T cell
CD3D	T cell
CD3E	T cell
CD3G	T cell
CD69	T cell
CD8A	T cell
CXCR1	T cell
CXCR4	T cell
CXCR5	T cell
CXCR6	T cell
FGFBP2	T cell
FLT3	T cell
FOSL1	T cell
GRAP2	T cell
HLA-DRA	T cell
HLA-DRB1	T cell
HLA-DRB5	T cell
HRH2	T cell
IFNG	T cell
IL10	T cell
IL12B	T cell
IL12RB1	T cell
IL12RB2	T cell
IL18R1	T cell
IL18RAP	T cell
IL1B	T cell
IL21	T cell
IL21R	T cell
IL24	T cell
IL26	T cell
IL27	T cell
IL2RA	T cell
IL6	T cell
IL7	T cell
IRF4	T cell
IRF8	T cell
ITGAL	T cell
ITK	T cell
JAK2	T cell
JAK3	T cell
LAIR1	T cell
LAT	T cell
LAX1	T cell
LCK	T cell
LCP2	T cell
LILRA3	T cell
LILRA4	T cell
LILRB1	T cell
LILRB2	T cell
LILRB3	T cell
LILRB4	T cell
MS4A4A	T cell
NAPSB	T cell
NFATC1	T cell
NFKB2	T cell
P2RY14	T cell
PIK3CD	T cell
POU2F2	T cell
PRF1	T cell
RUNX3	T cell
SPI1	T cell
STAT1	T cell
STAT4	T cell
TNF	T cell
TPRG1	T cell
TSLP	T cell
UBASH3B	T cell
ZAP70	T cell
PLA1A	Activated dendritic cell
HESX1	Activated dendritic cell
MMP12	Activated dendritic cell
TNFAIP6	Activated dendritic cell
MSC	Activated dendritic cell
CCL8	Activated dendritic cell
DHX58	Activated dendritic cell
IDO	Activated dendritic cell
RSAD2	Activated dendritic cell
IFI44L	Activated dendritic cell
HTR2B	Activated dendritic cell
PTGIR	Activated dendritic cell
TREM2	Activated dendritic cell
ST3GAL6	Activated dendritic cell
CYP27A1	Activated dendritic cell
FAM70A	Activated dendritic cell
KYNU	Activated dendritic cell
RASSF4	Activated dendritic cell
IL2RA	Activated dendritic cell
SLC2A6	Activated dendritic cell
CCL5	Activated dendritic cell
CD80	Activated dendritic cell
FPR3	Activated dendritic cell
SLC15A3	Activated dendritic cell
CD86	Activated dendritic cell
PDCD1LG2	Activated dendritic cell
CXCL10	Activated dendritic cell
CXCL11	Activated dendritic cell
TNFRSF4	Activated dendritic cell
EBI3	Activated dendritic cell
ARHGAP22	Activated dendritic cell
PLA2G7	Activated dendritic cell
CCL18	Activated dendritic cell
LAMP3	Activated dendritic cell
SIGLEC1	Activated dendritic cell
CCL1	Activated dendritic cell
CCL13	Activated dendritic cell
NR4A3	Activated dendritic cell
CLIC2	Activated dendritic cell
BIRC3	Activated dendritic cell
CCL20	Activated dendritic cell
TNFRSF11A	Activated dendritic cell
IL12B	Activated dendritic cell
CCL19	Activated dendritic cell
CCR7	Activated dendritic cell
CD1E	Activated dendritic cell
CD1B	Activated dendritic cell
CCL17	Activated dendritic cell
CCL22	Activated dendritic cell
SLCO5A1	Activated dendritic cell
ETV3	Activated dendritic cell
CHST7	Activated dendritic cell
MAP3K13	Activated dendritic cell
CCL19	Regulatory T cell
CD34	Regulatory T cell
CD72	Regulatory T cell
CTLA4	Regulatory T cell
FOXP3	Regulatory T cell
GADD45B	Regulatory T cell
GEM	Regulatory T cell
IL1RL1	Regulatory T cell
IL9R	Regulatory T cell
MADCAM1	Regulatory T cell
MYH10	Regulatory T cell
NCF2	Regulatory T cell
RCSD1	Regulatory T cell
RYR1	Regulatory T cell
SELE	Regulatory T cell
SELP	Regulatory T cell
SFRP1	Regulatory T cell
SIT1	Regulatory T cell
TIGIT	Regulatory T cell
TLR10	Regulatory T cell
TLR2	Regulatory T cell
TLR7	Regulatory T cell
TLR8	Regulatory T cell
TRAF1	Regulatory T cell
WIPF1	Regulatory T cell
TGFB1	Regulatory T cell
ADORA3	Myeloid-derived suppressor cell
AG2	Myeloid-derived suppressor cell
ARG1	Myeloid-derived suppressor cell
BIN2	Myeloid-derived suppressor cell
C1orf162	Myeloid-derived suppressor cell
CAPS	Myeloid-derived suppressor cell
CD117	Myeloid-derived suppressor cell
CD11B	Myeloid-derived suppressor cell
CD11C	Myeloid-derived suppressor cell
CD124	Myeloid-derived suppressor cell
CD14	Myeloid-derived suppressor cell
CD15	Myeloid-derived suppressor cell
CD163L1	Myeloid-derived suppressor cell
CD1D1	Myeloid-derived suppressor cell
CD21	Myeloid-derived suppressor cell
CD23	Myeloid-derived suppressor cell
CD274	Myeloid-derived suppressor cell
CD31	Myeloid-derived suppressor cell
CD35	Myeloid-derived suppressor cell
CD40	Myeloid-derived suppressor cell
CD43	Myeloid-derived suppressor cell
CD44	Myeloid-derived suppressor cell
CD66B	Myeloid-derived suppressor cell
COX2	Myeloid-derived suppressor cell
CR2	Myeloid-derived suppressor cell
CTR9	Myeloid-derived suppressor cell
EBP	Myeloid-derived suppressor cell
FAM48A	Myeloid-derived suppressor cell
FAM70B	Myeloid-derived suppressor cell
FCER2	Myeloid-derived suppressor cell
FCGRT	Myeloid-derived suppressor cell
FERMT3	Myeloid-derived suppressor cell
FLOT1	Myeloid-derived suppressor cell
FLT1	Myeloid-derived suppressor cell
GIMAP7	Myeloid-derived suppressor cell
GLI4	Myeloid-derived suppressor cell
GNA15	Myeloid-derived suppressor cell
GPR34	Myeloid-derived suppressor cell
GPSM3	Myeloid-derived suppressor cell
HLA-DR	Myeloid-derived suppressor cell
IDO	Myeloid-derived suppressor cell
IKZF1	Myeloid-derived suppressor cell
IL12	Myeloid-derived suppressor cell
IL13	Myeloid-derived suppressor cell
IL18BP	Myeloid-derived suppressor cell
IL1R	Myeloid-derived suppressor cell
IL4R	Myeloid-derived suppressor cell
INPP5D	Myeloid-derived suppressor cell
ITGA3	Myeloid-derived suppressor cell
KDR	Myeloid-derived suppressor cell
KRIT1	Myeloid-derived suppressor cell
LGALS3	Myeloid-derived suppressor cell
MGAT4A	Myeloid-derived suppressor cell
NAIP	Myeloid-derived suppressor cell
NEK3	Myeloid-derived suppressor cell
NFSF13	Myeloid-derived suppressor cell
NOG	Myeloid-derived suppressor cell
PARVG	Myeloid-derived suppressor cell
PDRG1	Myeloid-derived suppressor cell
PECAM1	Myeloid-derived suppressor cell
PIK3R5	Myeloid-derived suppressor cell
PPP1R2P4	Myeloid-derived suppressor cell
PSAP	Myeloid-derived suppressor cell
PTGES2	Myeloid-derived suppressor cell
PTPRE	Myeloid-derived suppressor cell
RNASE1	Myeloid-derived suppressor cell
RP11	Myeloid-derived suppressor cell
S100A8	Myeloid-derived suppressor cell
S100A9	Myeloid-derived suppressor cell
SELPLG	Myeloid-derived suppressor cell
SLA	Myeloid-derived suppressor cell
SLC36A1	Myeloid-derived suppressor cell
SLC44A1	Myeloid-derived suppressor cell
ST8SIA4	Myeloid-derived suppressor cell
STAT3	Myeloid-derived suppressor cell
STAT6	Myeloid-derived suppressor cell
TBXAS1	Myeloid-derived suppressor cell
TFGFB1	Myeloid-derived suppressor cell
TFGFB2	Myeloid-derived suppressor cell
TFGFB3	Myeloid-derived suppressor cell
TFGFB5	Myeloid-derived suppressor cell
TFRC	Myeloid-derived suppressor cell
TGFB2	Myeloid-derived suppressor cell
TPP1	Myeloid-derived suppressor cell
VTCN1	Myeloid-derived suppressor cell
CXCL9	Trafficking & infiltration
CXCL10	Trafficking & infiltration
CCL5	Trafficking & infiltration
CX3CL1	Trafficking & infiltration
LFA1	Trafficking & infiltration
ICAM1	Trafficking & infiltration
SELE	Trafficking & infiltration
HLA-A	Recognition of tumor cells
HLA-B	Recognition of tumor cells
HLA-C	Recognition of tumor cells
B2M	Recognition of tumor cells
TAP1	Recognition of tumor cells
TAP2	Recognition of tumor cells
PD-1	Immune checkpoints
BTLA	Immune checkpoints
TIM-3	Immune checkpoints
LAG3	Immune checkpoints
CTLA4	Immune checkpoints
PD-L1	Immune checkpoints
VISTA	Immune checkpoints
IL10	Other inhibitory molecules
IDO1	Other inhibitory molecules
TGFB1	Other inhibitory molecules
ARG1	Other inhibitory molecules
INOS	Other inhibitory molecules
CTNNB1	Other inhibitory molecules
